40
15
13 13 13 13 13 13 13 13 13 13 13 13 13 13 13 13 13 13 13 13 13 13 13 13 13 13 13 13 13 13 13 13 13 13 13 13 13 13 13 13
13  0  0  0  0  0  0  0  0  0  0  0  0  0  0  0  0  0  0  0  0  0  0  0  0  0  0  0  0  0  0  0  0  0  0  0  0  0  0 13
13  0  0  0  0  0  0  0  0  0  0  0  0  0  0  0  0  0  0  0  0  0  0  0  0  0  0  0  0  0  0  0  0  0  0  0  0  0  0 13
13  0  0  0  0  0  0  0  0  0  0  0  0  0  0  0  0  0  0  0  0  0  0  0  0  0  0  0  0  0  0  0  0  0  0  0  0  0  0 13
13  0  0  0  0  0  0  0  0  0  0  0  0  0  0  0  0  0  0  0  0  0  0  0  0  0  0  0  0  0  0  0  0  0  0  0  0  0  0 13
13  0  0  0  0  0  0  0  0  0  0  0  0  0  0  0  0  0  0  0  0  0  0  0  0  0  0  0  0  0  0  0  0  0  0  0  0  0  0 13
13  0  0  0  0  0  0  0  0  0  0  0  0  0  0  0  0  0  0  0  0  6 14  7  0  0  0  0  0  0  0  0  0  0  6 14  7  0  0 13
13  0  0  0  0  0  0  0  0  0  0  0  0  0  0  0  0  0  0  0  0  0 11  0  0  0  0  0  0  0  0  0  6 14  7 11  0  0  0 13
13  0  0  0  0  0  0  0  0  0  6 14  7  0  0  0  0  6 14  7  0  0  0  0  0  0  0  0  0  0  0  0  0 11  0  0  0  0  0 13
13  0  0  0  0  0  0  0  6 14  7 11  0  0  0  0  6 14  7  0  0  0  0  0  0  0  0  0  0  6 14  7  0  0  0  0  0  0  0 13
13  0  0  0  0  0  2  0  0 11  0  0  0  0  6 14  7 11  0  0  0  0  0  0  0  0  0  0  6 14  7  0  0  0  0  0  0  0  0 13
13  0  0  0  0  2 14  0  0  0  0  0  0  0  0 11  0  0  0  0  0  0  0  0  0  0  0  0  0 11  0  0  0  0  0  0  0  0  0 13
13  0  0  0  2 14 13  2  0  0  0  0  0  0  0  0  0  0  0  0  0  0  0  0  0  0  0  0  0  0  0  0  0  0  0  0  0  0  0 13
13  0  0  4 14 13 13 14  5  0  0  0  0  0  0  0  0  0  0  0  0  0  0  0  0  0  0  0  0  0  0  0  0  0  0  0  0  0  0 13
13 14 14 14 13 13 13 13 14 14 14 14 14 14 14 14 14 14 14 14 14 14 14 14 14 14 14 14 14 14 14 14 14 14 14 14 14 14 14 13